00000000000000000000000000000000000000000000000000000000000000000000000000000000000000000000000000000000000000000000000000000000
00000000000000000000000000000000000000000000000000000000000000000000000000000000000000000000000000000000000000000000000000000000
00000000000000000000000000000000000000000000000000000000000000000000000000000000000000000000000000000000000000000000000000000000
00000000000000000000000000000000000000000000000000000000000000000000000000000000000000000000000000000000000000000000000000000000
000000000000000000000000000000000000000000002c2c2c000000000000000000000000000000000000000000000000000000000000000000000000000000
0000000000002c000000000000000000000000002c2c3030302c0000000000000000000000000000000000000000000000000000000000000000000000000000
00000000002c302c00002c000000002c002c2c2c30303030302c0000000000000000000000000000000000000000000000000000000000000000000000000000
00000000002c302c002c302c00002c302c30302c30302c302c000000000000000000000000000000000000000000000000000000000000000000000000000000
00000000002c30302c2c302c00002c302c303030303030302c000000000000000000000000000000000000000000000000000000000000000000000000000000
0000000000002c302c30302c00002c302c302c2c302c2c2c00000000000000000000000000000000000000000000000000000000000000000000000000000000
0000000000002c302c302c0000002c3030302c002c0000002c000000000000000000000000000000000000000000000000000000000000000000000000000000
0000000000002c3030302c0000002c30302c00002c2c2c2c302c0000000000000000000000000000000000000000000000000000000000000000000000000000
000000000000002c2c302c0000002c30302c002c3030302c302c0000000000000000000000000000000000000000000000000000000000000000000000000000
00000000000000002c302c000000002c302c002c3030302c302c0000000000000000000000000000000000000000000000000000000000000000000000000000
00000000000000002c302c000000002c302c002c3030302c30302c00000000000000000000000000000000000000000000000000000000000000000000000000
000000002c2c2c00002c0000000000002c00002c30302c3030302c00000000000000000000000000000000000000000000000000000000000000000000000000
00002c2c3030302c0000000000000000000000002c2c2c302c302c00000000000000000000000000000000000000000000000000000000000000000000000000
002c30303030302c00000000000000002c002c2c00002c3030302c00000000000000000000000000000000000000000000000000000000000000000000000000
002c302c2c30302c000000000000002c302c30302c002c30302c0000000000000000000000000000000000000000000000000000000000000000000000000000
00002c00002c302c000000000000002c303030302c000030302c0000000000000000000000000000000000000000000000000000000000000000000000000000
0000000000002c0000000000000000002c3030302c00002c302c0000000000000000000000000000000000000000000000000000000000000000000000000000
000000000000000000000000000000002c303030302c002c302c0000000000000000000000000000000000000000000000000000000000000000000000000000
00000000002c000000000000000000002c302c2c302c002c302c0000000000000000000000000000000000000000000000000000000000000000000000000000
000000002c302c0000000000000000002c30302c302c00002c000000000000000000000000000000000000000000000000000000000000000000000000000000
000000002c302c0000000000000000002c303030302c000000000000000000000000000000000000000000000000000000000000000000000000000000000000
000000002c302c0000000000000000002c3030302c00000000000000000000000000000000000000000000000000000000000000000000000000000000000000
000000002c302c0000000000000000002c2c2c2c0000000000000000000000000000000000000000000000000000000000000000000000000000000000000000
00000000002c00000000000000000000000000000000000000000000000000000000000000000000000000000000000000000000000000000000000000000000
00000000000000000000000000000000000000000000000000000000000000000000000000000000000000000000000000000000000000000000000000000000
00000000000000000000000000000000000000000000000000000000000000000000000000000000000000000000000000000000000000000000000000000000
00000000000000000000000000000000000000000000000000000000000000000000000000000000000000000000000000000000000000000000000000000000
00000000000000000000000000000000000000000000000000000000000000000000000000000000000000000000000000000000000000000000000000000000
00000000000000000000000000000000000000000000000000000000000000000000000000000000000000000000000000000000000000000000000000000000
00000000000000000000000000000000000000000000000000000000000000000000000000000000000000000000000000000000000000000000000000000000
00000000000000000000000000000000000000000000000000000000000000000000000000000000000000000000000000000000000000000000000000000000
00000000000000000000000000000000000000000000000000000000000000000000000000000000000000000000000000000000000000000000000000000000
00000000000000000000000000000000000000000000000000000000000000000000000000000000000000000000000000000000000000000000000000000000
00000000000000000000000000000000000000000000000000000000000000000000000000000000000000000000000000000000000000000000000000000000
00000000000000000000000000000000000000000000000000000000000000000000000000000000000000000000000000000000000000000000000000000000
00000000000000000000000000000000000000000000000000000000000000000000000000000000000000000000000000000000000000000000000000000000
00000000000000000000000000000000000000000000000000000000000000000000000000000000000000000000000000000000000000000000000000000000
00000000000000000000000000000000000000000000000000000000000000000000000000000000000000000000000000000000000000000000000000000000
00000000000000000000000000000000000000000000000000000000000000000000000000000000000000000000000000000000000000000000000000000000
00000000000000000000000000000000000000000000000000000000000000000000000000000000000000000000000000000000000000000000000000000000
00000000000000000000000000000000000000000000000000000000000000000000000000000000000000000000000000000000000000000000000000000000
00000000000000000000000000000000000000000000000000000000000000000000000000000000000000000000000000000000000000000000000000000000
00000000000000000000000000000000000000000000000000000000000000000000000000000000000000000000000000000000000000000000000000000000
00000000000000000000000000000000000000000000000000000000000000000000000000000000000000000000000000000000000000000000000000000000
00000000000000000000000000000000000000000000000000000000000000000000000000000000000000000000000000000000000000000000000000000000
00000000000000000000000000000000000000000000000000000000000000000000000000000000000000000000000000000000000000000000000000000000
00000000000000000000000000000000000000000000000000000000000000000000000000000000000000000000000000000000000000000000000000000000
00000000000000000000000000000000000000000000000000000000000000000000000000000000000000000000000000000000000000000000000000000000
00000000000000000000000000000000000000000000000000000000000000000000000000000000000000000000000000000000000000000000000000000000
00000000000000000000000000000000000000000000000000000000000000000000000000000000000000000000000000000000000000000000000000000000
00000000000000000000000000000000000000000000000000000000000000000000000000000000000000000000000000000000000000000000000000000000
00000000000000000000000000000000000000000000000000000000000000000000000000000000000000000000000000000000000000000000000000000000
00000000000000000000000000000000000000000000000000000000000000000000000000000000000000000000000000000000000000000000000000000000
00000000000000000000000000000000000000000000000000000000000000000000000000000000000000000000000000000000000000000000000000000000
00000000000000000000000000000000000000000000000000000000000000000000000000000000000000000000000000000000000000000000000000000000
00000000000000000000000000000000000000000000000000000000000000000000000000000000000000000000000000000000000000000000000000000000
00000000000000000000000000000000000000000000000000000000000000000000000000000000000000000000000000000000000000000000000000000000
00000000000000000000000000000000000000000000000000000000000000000000000000000000000000000000000000000000000000000000000000000000
00000000000000000000000000000000000000000000000000000000000000000000000000000000000000000000000000000000000000000000000000000000
00000000000000000000000000000000000000000000000000000000000000000000000000000000000000000000000000000000000000000000000000000000
